

F 47,82,65


                  SO          ./assets/textures/west.xpm      





                C 0     ,0,0
EA        ./assets/textures/west.xpm




NO  ./assets/textures/west.xpm                     




WE           ./assets/textures/west.xpm    




        1111111111111111111111111
        1000000000110000000000001
        101100000111000000100N001
        1001000000000000010000001
111111111011000001110000000000001
100000000011000001110111110011111
11110111111 11011100000010001 
11110111111111011101010010001
1000000011010101110000010001
10000000000000001100000010001
10000000000000001101010010001
110000011101010111110111100111
11110111 1110101 101111010001
11111111 1111111 111111111111


            

                  

                  