NO ./texture/1c61b0435af5cc9d01a1a3364ae31abc.xpm
SO ./texture/east.xpm
EA ./texture/ross-elder-uXQVNkam3hE-unsplash.xpm
WE ./texture/sprite.xpm

F 54,126,24
C 137,207,253

5555555 1111111111111111111111111
5555555 1000000000010000000000001
5555555 1010000000010000000000001
5555555 1N00000000010000000000001
111111111000000000010000000000001
100000000000000000010111111111111
111101110000000000010000000010001
111101111111111111111001000111111
11000000110101011100000000001 555
10000000000000000000000010001 555
10000000000000001101010010001 555
11000001110101011111011110001 555
11110111 1110101 101111010001 555
11111111 1111111 11111111111  555
